6 5
3
1 7
2 3
4 3
########
####   #
##   # #
## @ @ #
#  #####
# ###  #
#  ##@ #
#      #
########
