6 5
3
6 1
5 5
3 5
########
#    @ #
#    # #
####   #
#### @##
# @    #
#   #  #
########
